111111111111111111111111111111111111111
1P010000000000000000000C100000000000001
10010C100000001111111111100000000000001
100100100000000000000000000000000010001
100111100000000000000111111111111110001
1001000000000000000000000000C0000010001
100000001111100000000111111111111110001
100001000C00100000000000000000000C100E1
111111111111111111111111111111111111111