111111111111111111111111111111111111111
1P010000000000X00000000C100000000000001
10010C1X0000000011111111100000000000001
1001001X0000000000000000000000000010001
1001111X0000000000000111111111111110001
100100000000000X000000000000C0000010001
1000000011111X0000000111111111111110001
100001000C00100000000000000000000C1X0E1
111111111111111111111111111111111111111